1111111111111
10000P0000001
11E1111111111