11111111111
11000000001
EP111111101