111111111
100001111
10C00EP01
111111111