111111111
10E001111
10C000001
1000000P1
111111111