11111111111
11000000001
1P111111101